0 0 0 0 0 1 0 0 5 7 0 1 1 0 9 0 1 1 0 0 0 0 0 1 0 7 0 0 0 99
0 0 5 7 0 1 0 0 2 0 0 1 0 0 0 0 0 1 0 0 0 0 0 1 0 0 0 5 0 99
0 0 0 0 0 1 0 0 0 0 0 1 0 0 1 0 0 1 1 0 7 0 0 1 0 7 0 0 1 99
0 0 0 2 0 1 0 0 0 0 0 1 0 0 2 0 0 1 0 2 0 0 5 1 0 0 0 1 0 99
0 0 0 0 0 1 0 0 0 0 0 1 1 0 9 0 1 1 0 0 0 0 0 1 0 0 0 2 0 99
1 1 1 1 1 1 1 1 1 1 1 1 1 1 1 1 1 1 1 1 1 1 1 1 1 1 1 1 1 99
0 0 0 0 0 0 0 0 1 1 9 1 1 1 1 0 0 0 0 0 0 0 0 1 0 6 6 6 4 99
0 0 0 0 0 0 0 0 1 1 0 0 0 1 1 0 0 0 0 0 0 0 0 1 0 1 1 1 1 99
0 0 0 0 0 0 0 0 1 1 0 1 0 1 1 0 7 7 0 0 0 0 0 1 8 8 8 8 0 99
1 0 0 7 0 0 0 0 1 1 0 2 0 1 1 0 1 0 7 0 0 0 0 1 1 1 1 1 6 99
0 2 0 5 7 0 0 0 1 1 1 1 9 1 1 0 0 2 5 7 0 0 0 1 2 6 8 6 8 99