1 1 1 1 0 0 6 6 6 6 6 0 8 8 8 8 8 0 99
0 0 0 1 0 0 9 1 1 1 1 1 1 1 1 1 1 0 99
0 2 0 1 0 0 9 1 0 0 0 0 0 0 0 0 0 0 99
0 0 0 0 0 0 9 1 0 1 1 1 1 1 1 1 1 1 99
1 1 1 1 1 1 1 1 0 0 0 0 8 8 8 8 0 0 99
1 1 1 1 1 1 1 1 1 1 1 1 1 1 1 1 9 0 99
9 9 9 9 9 9 9 1 9 9 9 9 9 9 9 9 9 0 99
9 0 3 5 8 6 9 1 0 0 6 6 6 6 0 4 9 0 99
9 0 2 0 0 6 9 1 0 1 9 9 9 9 9 9 1 0 99
9 0 7 3 0 6 9 1 0 0 0 0 0 0 0 0 0 0 99
9 9 9 9 9 9 9 1 1 9 9 9 9 9 9 9 9 1 99