0 0 0 0 1 4 1 9 9 9 9 99
0 2 0 0 1 8 1 2 0 0 6 99
0 5 3 0 1 8 1 0 0 0 0 99
0 0 0 0 1 8 1 8 8 8 9 99
0 1 1 1 1 8 1 1 1 1 1 99
0 0 0 0 0 0 6 6 6 6 0 99
0 1 1 1 1 8 1 1 1 1 0 99
0 0 0 0 1 8 1 0 0 0 0 99
0 0 0 1 1 8 1 0 7 0 0 99
0 0 1 1 1 8 1 0 3 0 0 99
0 0 0 0 0 8 0 0 0 0 0 99