1 1 1 1 1 0 0 0 0 0 0 0 0 0 0 0 0 0 1 99
1 1 1 1 1 0 1 0 1 0 1 0 1 0 1 1 0 0 1 99
1 1 1 1 1 0 1 0 1 0 1 0 1 0 1 0 1 0 1 99
1 1 1 1 1 0 1 1 1 0 1 0 1 0 1 1 0 0 1 99
1 1 1 1 1 0 1 0 1 0 1 0 1 0 1 0 1 0 1 99
1 1 1 1 1 0 1 0 1 0 1 1 1 0 1 1 0 0 1 99
1 1 1 1 1 0 0 0 0 0 0 0 0 0 0 0 0 0 1 99
1 1 1 1 1 1 1 1 1 1 1 1 1 1 1 1 1 1 1 1 1 1 1 99
0 0 1 4 1 4 1 4 1 4 1 4 1 4 1 4 1 4 1 4 1 4 1 99
0 0 1 0 1 0 1 0 1 0 1 0 1 0 1 0 1 0 1 0 1 0 1 99
2 0 0 0 0 0 0 0 0 0 0 0 0 0 0 0 0 0 0 0 0 0 0 99
0 0 0 1 0 1 0 1 0 1 0 1 0 1 0 1 0 1 0 1 0 1 0 99
0 0 0 1 4 1 4 1 4 1 4 1 4 1 4 1 4 1 4 1 4 1 4 99