0 0 0 0 1 0 0 0 0 99
0 4 0 0 1 0 3 0 0 99
0 0 0 0 8 0 0 0 0 99
0 0 0 0 8 0 0 0 0 99
1 1 1 1 1 6 6 1 1 99
9 0 0 0 1 0 0 0 0 99
9 0 5 0 1 0 2 0 0 99
9 0 3 2 1 0 7 0 0 99
9 0 0 0 1 0 0 0 0 99