9 9 9 9 9 9 9 9 99
9 4 9 5 0 3 0 9 99
9 0 9 9 9 9 0 9 99
9 0 9 9 9 9 0 9 99
9 0 0 0 6 0 0 9 99
9 9 9 9 9 9 0 9 99
9 2 0 0 0 0 0 9 99
9 9 9 9 9 9 9 9 99