2 0 0 0 0 1 2 9 0 0 0 99
0 9 0 0 0 1 0 0 0 0 0 99
0 0 0 9 0 1 0 0 0 0 0 99
0 0 0 0 0 1 9 0 0 0 0 99
4 0 0 0 0 1 0 0 0 0 0 99
1 1 1 1 1 1 1 1 1 1 1 99
2 9 0 0 0 1 2 0 0 0 0 99
0 0 0 0 0 1 0 0 0 9 0 99
0 0 0 0 0 1 0 0 0 0 0 99
0 9 0 0 0 1 0 0 9 0 0 99
0 0 0 0 9 1 0 0 0 0 0 99