0 0 0 0 0 1 0 0 0 0 0 99
0 0 3 0 0 1 0 0 0 2 0 99
0 0 0 0 0 1 0 0 0 0 0 99
0 0 0 0 0 1 0 0 5 0 0 99
0 2 0 0 0 1 0 0 0 0 0 99
0 0 0 0 0 1 0 0 3 0 0 99
6 6 6 6 6 1 0 0 0 0 0 99
0 0 0 0 0 1 8 8 8 8 8 99
0 0 0 0 0 1 0 0 0 0 0 99
0 0 7 0 0 1 0 0 4 0 0 99
0 0 0 0 0 1 0 0 0 0 0 99