9 9 1 0 9 1 9 1 9 1 1 1 1 99
9 0 0 0 0 5 9 1 9 1 1 1 1 99
9 0 0 0 9 1 1 1 9 1 1 1 1 99
9 0 0 0 9 1 4 1 9 1 1 1 1 99
9 0 0 0 9 1 8 1 9 1 1 1 1 99
9 0 0 0 9 1 0 1 9 9 9 9 9 99
9 0 0 0 9 1 6 1 9 0 0 0 9 99
9 0 0 0 9 1 2 1 9 0 2 0 9 99
9 0 2 0 9 1 1 1 1 0 0 0 9 99
9 0 0 0 9 1 9 7 0 0 0 0 9 99
9 0 0 0 9 1 9 0 0 0 0 1 9 99