0 0 0 0 0 0 0 0 0 0 0 0 0 0 0 0 0 0 0 0 0 99
0 1 1 1 0 1 0 1 0 1 1 1 0 1 1 1 0 1 0 1 0 99
0 1 0 0 0 1 0 1 0 1 0 0 0 1 0 0 0 1 0 1 0 99
0 1 0 0 0 1 1 1 0 1 1 1 0 1 1 1 0 1 1 1 0 99
0 1 0 0 0 1 0 1 0 1 0 0 0 0 0 1 0 1 0 1 0 99
0 1 1 1 0 1 0 1 0 1 1 1 0 1 1 1 0 1 0 1 0 99
0 0 0 0 0 0 0 0 0 0 0 0 0 0 0 0 0 0 0 0 0 99
0 2 0 0 0 0 0 0 0 0 0 0 0 0 0 0 0 0 0 4 0 99
0 0 0 0 0 0 0 0 0 0 0 0 0 0 0 0 0 0 0 0 0 99