0 0 0 0 0 0 0 0 8 0 7 99
8 8 8 1 1 0 1 1 1 1 1 99
6 6 6 1 1 0 1 5 0 0 0 99
0 0 0 1 1 0 1 1 3 1 0 99
0 3 0 1 1 2 0 0 0 1 0 99
0 0 0 1 1 1 0 1 0 1 0 99
1 1 1 1 1 1 0 1 0 1 0 99
1 1 1 0 0 0 0 0 0 1 0 99
2 7 1 0 1 1 1 1 1 1 0 99
8 1 1 0 0 0 0 0 0 0 0 99
0 1 1 1 1 1 1 1 1 1 1 99
0 0 8 8 8 8 8 8 8 0 0 99
1 1 1 1 1 1 1 1 1 1 0 99
4 0 8 8 8 8 8 8 8 0 0 99