9 9 9 9 9 9 9 9 9 9 9 99
9 0 1 0 9 0 0 0 0 0 9 99
9 0 9 0 9 0 9 0 9 0 9 99
9 0 0 0 0 0 1 0 9 2 9 99
9 0 9 0 9 0 9 0 9 0 9 99
9 0 1 0 9 0 0 0 0 0 9 99
9 9 9 9 9 9 9 9 9 9 9 99
1 1 1 1 1 1 1 1 1 1 1 99
0 0 0 0 0 9 0 0 9 0 0 99
2 0 9 0 0 9 0 0 0 0 4 99
0 0 9 0 0 0 0 0 9 0 0 99