9 9 9 9 9 9 9 9 9 9 99
9 2 0 0 9 0 9 0 6 4 99
9 0 1 0 9 0 0 0 9 9 99
9 0 0 0 9 0 9 0 0 9 99
9 1 9 9 9 0 0 0 0 9 99
9 9 9 9 9 0 0 0 0 9 99
9 9 2 5 0 0 0 9 0 9 99
9 9 0 0 0 0 0 3 0 9 99
9 9 9 9 9 0 0 1 9 9 99
9 9 9 9 9 9 9 9 9 9 99