4 6 8 2 0 0 0 0 99
1 1 1 1 1 1 1 0 99
0 0 0 0 0 0 0 0 99
0 9 0 0 9 3 0 0 99
0 0 0 0 0 0 3 0 99
0 7 0 9 0 0 0 0 99
0 0 5 0 0 0 9 0 99
0 0 0 0 0 0 0 0 99