9 9 9 6 0 0 0 0 0 0 0 99
0 0 1 6 0 0 0 0 0 0 0 99
0 2 0 6 0 3 0 7 0 0 0 99
0 0 1 6 0 0 0 0 0 0 0 99
9 9 9 6 0 0 0 0 0 0 0 99
1 1 1 1 1 1 1 1 1 1 1 99
0 0 0 0 0 0 0 8 0 0 0 99
0 0 0 9 0 3 0 8 0 0 0 99
0 0 0 9 0 0 0 8 0 4 0 99
0 0 0 9 0 5 0 8 0 0 0 99
0 2 0 9 0 0 0 8 0 0 0 99