0 0 0 9 0 0 0 0 6 0 0 99
0 2 0 9 0 0 0 0 6 0 0 99
0 0 0 9 0 0 9 0 6 0 4 99
0 0 0 0 0 0 9 0 6 0 0 99
0 0 0 0 0 0 9 0 6 0 0 99
1 1 1 1 1 1 1 1 1 1 1 99
0 0 0 0 0 0 0 0 0 0 0 99
0 0 0 0 0 0 0 0 0 0 0 99
0 2 0 5 0 0 0 0 0 3 0 99
0 0 0 0 0 0 0 0 0 0 0 99
0 0 0 0 0 0 0 0 0 0 0 99