0 0 6 0 0 1 0 0 0 0 0 99
2 0 6 0 0 1 0 0 3 0 0 99
0 0 6 4 0 1 0 0 0 0 0 99
1 0 6 0 0 1 8 8 8 8 8 99
7 0 6 0 0 1 0 0 0 0 0 99
1 1 1 1 1 1 0 0 0 0 0 99
0 0 0 0 0 8 0 0 0 0 0 99
0 0 0 0 0 8 0 0 0 0 0 99
0 0 5 0 0 8 0 0 2 0 0 99
0 0 0 0 0 8 0 0 0 0 0 99
0 0 0 0 0 8 0 0 0 0 0 99