0 0 0 0 0 1 0 5 0 2 1 0 0 0 2 1 9 9 9 9 9 99
1 0 9 0 5 1 0 0 0 0 1 0 0 1 1 1 9 1 0 1 9 99
1 0 0 0 1 1 6 6 6 6 1 0 8 0 0 1 9 0 0 0 9 99
1 6 6 6 6 1 0 0 0 0 1 1 9 9 0 1 9 0 2 0 9 99
1 0 0 0 9 1 1 0 9 9 1 0 0 0 0 1 9 1 0 1 9 99
1 2 0 0 0 1 0 0 0 7 1 4 9 9 9 1 9 9 9 9 9 99