1 2 6 6 6 9 6 6 1 0 0 0 0 0 99
1 1 1 9 6 6 6 9 1 0 0 0 0 0 99
1 1 1 6 6 6 6 6 1 0 0 3 0 0 99
1 1 1 9 6 6 6 9 1 0 0 0 0 0 99
1 1 1 6 6 9 6 6 1 0 0 0 0 0 99
1 1 1 1 1 1 1 1 1 0 0 0 0 0 99
5 5 5 5 0 0 0 0 1 0 0 7 0 0 99
5 0 0 5 5 5 5 0 1 0 0 0 0 0 99
5 5 5 5 0 0 5 0 1 0 0 0 0 0 99
1 1 1 5 0 5 5 0 1 1 1 6 0 1 99
2 5 5 5 5 5 0 0 1 2 6 6 8 4 99