9 9 9 9 9 9 9 9 9 9 9 99
9 2 2 0 0 0 0 0 0 0 9 99
9 1 1 1 1 1 9 0 0 9 9 99
9 0 0 0 0 9 0 0 0 0 9 99
9 0 0 9 0 0 0 0 9 0 9 99
9 9 0 0 0 0 9 0 0 0 9 99
9 0 0 0 9 0 0 0 0 0 9 99
9 0 0 9 0 0 0 9 0 0 9 99
9 0 0 0 0 0 9 0 0 4 9 99
9 0 9 0 9 0 0 0 9 0 9 99
9 9 9 9 9 9 9 9 9 9 9 99